"","torneo","Barrera","Chochos","Dani","VÃ©lez","Total_Puntos"
"1","Champions League",59,54,44,41,198
"2","Europa League",28,34,29,22,113
"3","Leagues Cup",23,22,22,14,81
"4","Sudamericana",16,10,10,13,49
"5","Conference",9,8,11,6,34
"6","AFC Champions League Elite",6,5,8,12,31
"7","Libertadores",6,7,8,5,26
"8","CAF Champions League",1,1,1,1,4
"9","Champions Cup",1,1,1,1,4
"10","AFC Champions League",0,0,0,1,1
